isMobile=>Check if is Mobile,
isTablet=>Check if is Tablet,
isiPhone=>Check if is iPhone,
isBlackBerry=>Check if is BlackBerry,
isHTC=>Check if is HTC,
isNexus=>Check if is Nexus,
isDell=>Check if is Dell,
isMotorola=>Check if is Motorola,
isSamsung=>Check if is Samsung,
isLG=>Check if is LG,
isSony=>Check if is Sony,
isAsus=>Check if is Asus,
isMicromax=>Check if is Micromax,
isPalm=>Check if is Palm,
isVertu=>Check if is Vertu,
isPantech=>Check if is Pantech,
isFly=>Check if is Fly,
isWiko=>Check if is Wiko,
isiMobile=>Check if is iMobile,
isSimValley=>Check if is SimValley,
isWolfgang=>Check if is Wolfgang,
isAlcatel=>Check if is Alcatel,
isNintendo=>Check if is Nintendo,
isAmoi=>Check if is Amoi,
isINQ=>Check if is INQ,
isGenericPhone=>Check if is GenericPhone,
isiPad=>Check if is iPad,
isNexusTablet=>Check if is NexusTablet,
isSamsungTablet=>Check if is SamsungTablet,
isKindle=>Check if is Kindle,
isSurfaceTablet=>Check if is SurfaceTablet,
isHPTablet=>Check if is HPTablet,
isAsusTablet=>Check if is AsusTablet,
isBlackBerryTablet=>Check if is BlackBerryTablet,
isHTCtablet=>Check if is HTCtablet,
isMotorolaTablet=>Check if is MotorolaTablet,
isNookTablet=>Check if is NookTablet,
isAcerTablet=>Check if is AcerTablet,
isToshibaTablet=>Check if is ToshibaTablet,
isLGTablet=>Check if is LGTablet,
isFujitsuTablet=>Check if is FujitsuTablet,
isPrestigioTablet=>Check if is PrestigioTablet,
isLenovoTablet=>Check if is LenovoTablet,
isDellTablet=>Check if is DellTablet,
isYarvikTablet=>Check if is YarvikTablet,
isMedionTablet=>Check if is MedionTablet,
isArnovaTablet=>Check if is ArnovaTablet,
isIntensoTablet=>Check if is IntensoTablet,
isIRUTablet=>Check if is IRUTablet,
isMegafonTablet=>Check if is MegafonTablet,
isEbodaTablet=>Check if is EbodaTablet,
isAllViewTablet=>Check if is AllViewTablet,
isArchosTablet=>Check if is ArchosTablet,
isAinolTablet=>Check if is AinolTablet,
isSonyTablet=>Check if is SonyTablet,
isPhilipsTablet=>Check if is PhilipsTablet,
isCubeTablet=>Check if is CubeTablet,
isCobyTablet=>Check if is CobyTablet,
isMIDTablet=>Check if is MIDTablet,
isMSITablet=>Check if is MSITablet,
isSMiTTablet=>Check if is SMiTTablet,
isRockChipTablet=>Check if is RockChipTablet,
isFlyTablet=>Check if is FlyTablet,
isbqTablet=>Check if is bqTablet,
isHuaweiTablet=>Check if is HuaweiTablet,
isNecTablet=>Check if is NecTablet,
isPantechTablet=>Check if is PantechTablet,
isBronchoTablet=>Check if is BronchoTablet,
isVersusTablet=>Check if is VersusTablet,
isZyncTablet=>Check if is ZyncTablet,
isPositivoTablet=>Check if is PositivoTablet,
isNabiTablet=>Check if is NabiTablet,
isKoboTablet=>Check if is KoboTablet,
isDanewTablet=>Check if is DanewTablet,
isTexetTablet=>Check if is TexetTablet,
isPlaystationTablet=>Check if is PlaystationTablet,
isTrekstorTablet=>Check if is TrekstorTablet,
isPyleAudioTablet=>Check if is PyleAudioTablet,
isAdvanTablet=>Check if is AdvanTablet,
isDanyTechTablet=>Check if is DanyTechTablet,
isGalapadTablet=>Check if is GalapadTablet,
isMicromaxTablet=>Check if is MicromaxTablet,
isKarbonnTablet=>Check if is KarbonnTablet,
isAllFineTablet=>Check if is AllFineTablet,
isPROSCANTablet=>Check if is PROSCANTablet,
isYONESTablet=>Check if is YONESTablet,
isChangJiaTablet=>Check if is ChangJiaTablet,
isGUTablet=>Check if is GUTablet,
isPointOfViewTablet=>Check if is PointOfViewTablet,
isOvermaxTablet=>Check if is OvermaxTablet,
isHCLTablet=>Check if is HCLTablet,
isDPSTablet=>Check if is DPSTablet,
isVistureTablet=>Check if is VistureTablet,
isCrestaTablet=>Check if is CrestaTablet,
isMediatekTablet=>Check if is MediatekTablet,
isConcordeTablet=>Check if is ConcordeTablet,
isGoCleverTablet=>Check if is GoCleverTablet,
isModecomTablet=>Check if is ModecomTablet,
isVoninoTablet=>Check if is VoninoTablet,
isECSTablet=>Check if is ECSTablet,
isStorexTablet=>Check if is StorexTablet,
isVodafoneTablet=>Check if is VodafoneTablet,
isEssentielBTablet=>Check if is EssentielBTablet,
isRossMoorTablet=>Check if is RossMoorTablet,
isiMobileTablet=>Check if is iMobileTablet,
isTolinoTablet=>Check if is TolinoTablet,
isAudioSonicTablet=>Check if is AudioSonicTablet,
isAMPETablet=>Check if is AMPETablet,
isSkkTablet=>Check if is SkkTablet,
isTecnoTablet=>Check if is TecnoTablet,
isJXDTablet=>Check if is JXDTablet,
isiJoyTablet=>Check if is iJoyTablet,
isFX2Tablet=>Check if is FX2Tablet,
isXoroTablet=>Check if is XoroTablet,
isViewsonicTablet=>Check if is ViewsonicTablet,
isOdysTablet=>Check if is OdysTablet,
isCaptivaTablet=>Check if is CaptivaTablet,
isIconbitTablet=>Check if is IconbitTablet,
isTeclastTablet=>Check if is TeclastTablet,
isOndaTablet=>Check if is OndaTablet,
isJaytechTablet=>Check if is JaytechTablet,
isBlaupunktTablet=>Check if is BlaupunktTablet,
isDigmaTablet=>Check if is DigmaTablet,
isEvolioTablet=>Check if is EvolioTablet,
isLavaTablet=>Check if is LavaTablet,
isCelkonTablet=>Check if is CelkonTablet,
isWolderTablet=>Check if is WolderTablet,
isMiTablet=>Check if is MiTablet,
isNibiruTablet=>Check if is NibiruTablet,
isNexoTablet=>Check if is NexoTablet,
isUbislateTablet=>Check if is UbislateTablet,
isPocketBookTablet=>Check if is PocketBookTablet,
isHudl=>Check if is Hudl,
isTelstraTablet=>Check if is TelstraTablet,
isGenericTablet=>Check if is GenericTablet,
isAndroidOS=>Check if is AndroidOS,
isBlackBerryOS=>Check if is BlackBerryOS,
isPalmOS=>Check if is PalmOS,
isSymbianOS=>Check if is SymbianOS,
isWindowsMobileOS=>Check if is WindowsMobileOS,
isWindowsPhoneOS=>Check if is WindowsPhoneOS,
isiOS=>Check if is iOS,
isMeeGoOS=>Check if is MeeGoOS,
isMaemoOS=>Check if is MaemoOS,
isJavaOS=>Check if is JavaOS,
iswebOS=>Check if is webOS,
isbadaOS=>Check if is badaOS,
isBREWOS=>Check if is BREWOS,
isChrome=>Check if is Chrome,
isDolfin=>Check if is Dolfin,
isOpera=>Check if is Opera,
isSkyfire=>Check if is Skyfire,
isIE=>Check if is IE,
isFirefox=>Check if is Firefox,
isBolt=>Check if is Bolt,
isTeaShark=>Check if is TeaShark,
isBlazer=>Check if is Blazer,
isSafari=>Check if is Safari,
isTizen=>Check if is Tizen,
isUCBrowser=>Check if is UCBrowser,
isbaiduboxapp=>Check if is baiduboxapp,
isbaidubrowser=>Check if is baidubrowser,
isDiigoBrowser=>Check if is DiigoBrowser,
isPuffin=>Check if is Puffin,
isMercury=>Check if is Mercury,
isObigoBrowser=>Check if is ObigoBrowser,
isNetFront=>Check if is NetFront,
isGenericBrowser=>Check if is GenericBrowser